3 4 3 4 3 3 3 3 3 3 
3 3 9 4 3 4 4 4 4 5 
3 3 4 3 3 9 3 4 4 4 
4 3 4 3 3 4 3 9 4 4 
4 3 3 3 4 4 4 4 4 4 