10   10   6       6       6        6       6     10   10   10 
6     10   10     10      10    10    10   10     6     13 
6     10   12     10     10     11    12   10     6     10
6     10   10     10      10     10   10   11     6     10
6     6      6      6         6       6      6     6      6     7